000000000000000000000
012202222202222222020
000202000202000002020
020222022222022202220
020000020200000200020
020222020222220202220
020202000000020202000
022202222222220202220
000000000002000200020
022222022222022222020
020002020000020000020
020222020202222202220
020000020202020002000
022222020222022202020
000202020000000202020
022202220202222222020
020000000202000000020
022202022202222202220
000202020200000202020
022202220222222222023
000000000000000000000
